11111111111111111111
10P00000000000000001
10000000000000000001
100000000000000000011
10000000000P00000000
11111111111111111111 