11111111111111111111
10PC0000000000000001
10000000000000000001
10000000000000000001
10000000000000000001
11111111111111111111