11111111111111111111
1EPC0000000000000001
10000000000000000001
10000000000000000001
100000000000000000011
11111111111111111111