1111111111111

1110000000001
1111110000001
1000000000001
1PCECC0000001
1111111111111