111111111111111111111111111111
1E1000000000000100010000000001
10100000001011C10001000000C001
101000001110011100010000000001
100000000C100000P0010000000011
111111111111111110011111110111
100000001100000000000000000011
100000001100000000000000000011
100000000000000000000000000011
111111111111111111111111111111