11111111111111111111
1E100000000000010001
10100000001011C10001
10100000111001110001
100000000C100000P001
11111111111111111111