11111111111111111111111111111
1E100000000000010001000000001
10100000001011C10001000000C01
10100000111001110001000000001
100000000C100000P001000000001
11111111111111111001111111011
10000000110000000000000000001
10000000110000000000000000001
10000000000000000000000000001
11111111111111111111111111111